-----------O------
-----------O------
-----------O------
-----------O--H---
-----OOO----------
-----------O------