-----------O------
-----------O------
--------H--O------
-----------O------
-----OOO----------
-----------O------